1111111101
1101001111
0111011111
1111111101
0011111111
0111101111
1101101111
